As far as i concerned - Dari sudut pandang
artificiality - tidaklah natural
as well as - 
at all - bagaimanapun juga
as such - dengan demikian / dengan benar-benar tepat
bound to be - menjadi ada / alaminya adalah
built-in - bawaan
by and by - perlahan-lahan / segera
cannot be helped - tak terelakkan
cultivated - menumbuhkembangkan / dilatih
circumstantial - situasional
deflating - menyusutkan / menurunkan
dependable - diharapkan
false - salah (dari bab 8, zen jepang)
get the idea - mengerti
matter - materi
Nothingness - Ketiadaan
Nature of things - sifat hal-hal
still - tenang
throw it off - membuang keluar

tension - kecemasan

Let it be as it is - Biarkan apa adanya
hold back - mencegahmu
immediately - terang-terangan
in advance - sebelumnya
in a way  - dengan cara / di satu sisi
in a sense - dalam arti tertentu 
in an ultimate sense - dalam arti akhir
in the sense - 
in some way or other - dalma berbagai cara atau versi
in the sense - dari segi
in place of - sebagai pengganti
in between  - 
in this way - Di cara ini
in relation - dalam hubungannya
it is not just - Tidak berarti
involuntary - tidak sukarela / memaksa
in particular - khususnya
jump in - menyela
leaving only what is - yang tersisa hanyalah
nothing - tidak ada 
not unless - kecuali
otherwise not - jika tidak maka hal itu tidak akan ada
really - sesungguhnya
realm - ranah
rememberance - Yang Terkenang
touchstone - kriteria
related - terkait
reason - nalar
renunciation - pengorbanan
something must be there - ada sesuatu di sana
take it away - 
transcendence - 

with the rest - seisi / seluruh
what you are - dirimu
what is to be - 
well-being= diri / kesejahteraan
work for - mendukung
The ultimate - inti


soon it will no longer be possible - tak lama hal itu tak lagi ada
